event_at,removed,observed,censored,entrance,at_risk
0.0,0,0,0,10000,10000
1.0,467,467,0,0,10000
2.0,460,460,0,0,9533
3.0,607,607,0,0,9073
4.0,671,671,0,0,8466
5.0,2177,484,1693,0,7795
6.0,3238,253,2985,0,5618
7.0,1699,81,1618,0,2380
8.0,574,20,554,0,681
9.0,102,2,100,0,107
10.0,5,0,5,0,5
