event_at,removed,observed,censored,entrance,at_risk
0.0,0,0,0,10000,10000
1.0,1230,1230,0,0,10000
2.0,1069,1069,0,0,8770
3.0,872,872,0,0,7701
4.0,588,588,0,0,6829
5.0,1711,391,1320,0,6241
6.0,2639,218,2421,0,4530
7.0,1362,57,1305,0,1891
8.0,435,9,426,0,529
9.0,88,1,87,0,94
10.0,5,0,5,0,6
11.0,1,0,1,0,1
