event_at,removed,observed,censored,entrance,at_risk
0.0,0,0,0,1000,1000
1.0,151,0,151,0,1000
2.0,90,0,90,0,849
3.0,41,0,41,0,759
4.0,327,298,29,0,718
5.0,194,185,9,0,391
6.0,105,100,5,0,197
7.0,59,59,0,0,92
8.0,25,24,1,0,33
9.0,7,7,0,0,8
10.0,1,1,0,0,1
