event_at,removed,observed,censored,entrance,at_risk
0.0,0,0,0,10000,10000
1.0,290,290,0,0,10000
2.0,5697,5687,10,0,9710
3.0,1705,1116,589,0,4013
4.0,1505,508,997,0,2308
5.0,580,231,349,0,803
6.0,165,69,96,0,223
7.0,42,14,28,0,58
8.0,12,4,8,0,16
9.0,2,1,1,0,4
10.0,2,0,2,0,2
