event_at,removed,observed,censored,entrance,at_risk
0.0,0,0,0,10000,10000
1.0,932,932,0,0,10000
2.0,1000,1000,0,0,9068
3.0,936,936,0,0,8068
4.0,670,670,0,0,7132
5.0,1801,451,1350,0,6462
6.0,2648,240,2408,0,4661
7.0,1413,58,1355,0,2013
8.0,508,12,496,0,600
9.0,83,3,80,0,92
10.0,7,0,7,0,9
11.0,2,0,2,0,2
