event_at,removed,observed,censored,entrance,at_risk
0.0,0,0,0,10000,10000
1.0,1186,1186,0,0,10000
2.0,1142,1142,0,0,8814
3.0,900,900,0,0,7672
4.0,623,623,0,0,6772
5.0,1688,417,1271,0,6149
6.0,2611,229,2382,0,4461
7.0,1278,54,1224,0,1850
8.0,488,19,469,0,572
9.0,73,3,70,0,84
10.0,11,0,11,0,11
