event_at,removed,observed,censored,entrance,at_risk
0.0,0,0,0,10000,10000
1.0,1183,1183,0,0,10000
2.0,1125,1125,0,0,8817
3.0,903,903,0,0,7692
4.0,598,598,0,0,6789
5.0,1707,383,1324,0,6191
6.0,2555,244,2311,0,4484
7.0,1382,74,1308,0,1929
8.0,451,24,427,0,547
9.0,89,1,88,0,96
10.0,7,0,7,0,7
