event_at,removed,observed,censored,entrance,at_risk
0.0,0,0,0,10000,10000
1.0,1200,1200,0,0,10000
2.0,1033,1033,0,0,8800
3.0,858,858,0,0,7767
4.0,604,604,0,0,6909
5.0,1737,387,1350,0,6305
6.0,2609,197,2412,0,4568
7.0,1405,58,1347,0,1959
8.0,446,8,438,0,554
9.0,94,2,92,0,108
10.0,12,0,12,0,14
11.0,1,0,1,0,2
12.0,1,0,1,0,1
