event_at,removed,observed,censored,entrance,at_risk
0.0,0,0,0,10000,10000
1.0,972,972,0,0,10000
2.0,925,925,0,0,9028
3.0,729,729,0,0,8103
4.0,634,634,0,0,7374
5.0,1879,460,1419,0,6740
6.0,2759,252,2507,0,4861
7.0,1478,56,1422,0,2102
8.0,519,10,509,0,624
9.0,92,2,90,0,105
10.0,12,0,12,0,13
11.0,1,0,1,0,1
