event_at,removed,observed,censored,entrance,at_risk
0.0,0,0,0,10000,10000
1.0,739,739,0,0,10000
2.0,918,918,0,0,9261
3.0,934,934,0,0,8343
4.0,669,669,0,0,7409
5.0,1885,428,1457,0,6740
6.0,2851,241,2610,0,4855
7.0,1421,72,1349,0,2004
8.0,477,17,460,0,583
9.0,90,1,89,0,106
10.0,15,0,15,0,16
11.0,1,0,1,0,1
